*4444444444*
**33333333**
*2222222222*
*2222222222*
****1111****